########################
#----------------------#
#-----------#####------#
#-----###--------------#
#----------------------#
#-###------------------#
#-----------###--------#
#--##------------------#
#----------------------#
#-------###---##-------#
#----------------------#
#---------------##-----#
#------###-------------#
#----------------------#
#---###---##-----#-----#
#----------------------#
#-#----------#########-#
#-##----#--------------#
#-----------------#----#
#--##-----##-----------#
#-----------------#----#
#----###------#####----#
#----------------------#
########################