########################
##----##-#----#-#---#-##
#--##-#----###--###----#
##--#---#####------##--#
#--##-##---#--####--#--#
##-#---#o#-##-#---#--#-#
#-#--#-###-#--#-#--#-#-#
#---##--#---#-#--#-#---#
#--#---#--#--##-#--##--#
#-###--#-###-#--#------#
#--#--#----#---#--###--#
#-----#-#######--###---#
#-#-#--#----#-----#--#-#
#-#-#---##-##-###---#--#
#-#-#-#--#-#-#----#-#--#
#-#-#-#-##---#--##---###
#-#-#-#-#--#---#---#---#
#-------##---#---#---#-#
#######----#---#---#---#
##---#---#---#---#---#-#
#--#---#---#---#---#---#
##---#---#---#---#---#-#
#--#---#---#---#---#---#
########################