################################
#--##-----------#---#----#----##
#--#---########-#-#-#--#---#---#
#--###----#---#-#-#-#---#---#--#
#----#--#-#-#-#-#-#-#-#-#---#--#
####--#-#-#-#-#-#-#-#---#---#--#
#---#-###-#-#-#-#-#-#--##--#---#
#-#-#---#---#-#-#-#---##---#---#
#-#--##--#-#--#---####---#----##
#-##--##--##---#--###---########
#-###--##---#--##--#--##------##
#---##------#--#####-#---###---#
###---#######--#-----#-##---#--#
####------###--#-####--#--#--#-#
#---#####---#--#-----#-#-###-#-#
#-#-----###-#--#####---#--#--#-#
#-#--#---##-#--#----#####--#---#
#-##--#-----#-#--#-#-----#--####
#-##---#####--#--#--##-#--#---##
#-#--#--#--#---#--#----#--###--#
#---###---###---#--####--#---#-#
#-##########---###---#--#--#-#-#
#-#-----##---###--##--#---#--#-#
#-#-#-#--#--#-----###--###--##-#
#-#-#-#--#----#--#####---#--##-#
#-#-#-##--####---#----##--#--#-#
#-#-#-------#---#--##---#--#---#
#---#--######--#--#---#--#-#####
####--#-----#----#--#---#--#--##
##---#--###--######---#-#-##---#
#--#---#####--------#---#----#o#
################################