################
#-###---#--#---#
#--#-##-##---#-#
##------#--#---#
#--#-##--#---#-#
#-##-#-----#---#
#----##-##---#-#
#-##----#--#####
#---#--###-----#
###--#----##-#-#
#--#-#--#--#-#-#
#-#--##---###--#
#-#--###-###--##
#--##-------#-##
#-----#-##----o#
################