/............\/............\
[------------][------------]
[-/..\-/...\-][-/...\-/..\-]
[#]##[-]###[-][-]###[-]##[#]
[-:..;-:...;-:;-:...;-:..;-]
[--------------------------]
[-/..\-/\-/......\-/\-/..\-]
[-:..;-]]-:..\/..;-[[-:..;-]
[------]]----[]----[[------]
:....\-]:..\#[]#/..;[-/....;
#####[-]/..;#:;#:..\[-]#####
#####[-]]##########[[-]#####
#####[-]]#/..##..\#[[-]#####
.....;-:;#[######[#:;-:.....
######-###[######[###-######
.....\-/\#[######[#/\-/.....
#####[-]]#:......;#[[-]#####
#####[-]]##########[[-]#####
#####[-]]#/......\#[[-]#####
/....;-:;#:..\/..;#:;-:....\
[------------[]------------]
[-/..\-/...\-[]-/...\-/..\-]
[-:.\]-:...;-:;-:...;-[/.;-]
[#--[]-------##-------[]--#]
:.\-[]-/\-/......\-/\-[]-/.;
/.;-:;-[]-:..\/..;-[]-:;-:.\
[------[]----[]----[]------]
[-/....;:..\-[]-/..;:....\-]
[-:........;-:;-:........;-]
[--------------------------]
:..........................;